111111111
133333331
133332331
133333331
133333331
111111111