1111111131
1333333331
1330323031
1333333331
1330334431
1333334431
1333333331
1111111131